alive	aluminum	asian	asphalt
bald	bare	beige	bent
big	black	black and white	blond
blonde	blue	brick	bright
brown	brunette	calm	caucasian
cement	circular	clean	clear
closed	cloudy	cold	colorful
concrete	cooked	covered	curly
curved	dark	denim	dirty
driving	dry	eating	empty
fabric	fat	filled	flat
floating	fluffy	flying	fresh
full	furry	glass	gold
gray	green	grey	hanging
happy	hard	heavy	high
huge	in motion	large	leafy
leaning	leather	light	lit
long	looking	messy	metal
moving	multicolored	murky	narrow
new	not moving	off	old
on	open	orange	overcast
painted	paper	parked	patterned
paved	pink	plaid	plastic
playing	powered on	pretty	purple
rectangular	red	red and white	reflective
round	rubber	running	rusted
rusty	sharp	shiny	short
shut	silver	sitting	skiing
skinny	small	smiling	snowy
soft	square	stacked	standing
steel	stone	stopped	straight
striped	talking	tall	tan
teal	thick	thin	tile
tiled	transparent	turned on	upright
walking	watching	wet	white
wide	wood	wooden	yellow
young
