above	across from
adjacent to	against
along	around
at	attached to
before	behind
below	beneath
beside	between
by	carrying
connected to	contains
covered by	covering
crossing	cutting
driving	eating
facing	floating on
hanging on	has
has on	holding
in	in front of
inside	leaning on
left of	looking at
lying on	moving on
near	next to
on	on top of
outside	over
parked next to	parked on
playing	pulling
riding	right of
says	sitting near
sitting next to	sitting on
standing near	standing next to
standing on	stopped on
swinging	taller than
tied to	touching
under	using
walking on	watching
wearing	with
